Demo = Level([12, 13, 14, 37, 38, 41, 42, 43, 44, 45, 46, 47, 48, 49, 50, 52, 58, 68, 69, 70, 71, 72, 73, 74, 84],
             [[9, 9, 50, 9, 9, 9, 22, 9, 52, 9, 24, 25, 25, 25, 25, 25, 25, 25, 25, 25, 26, 21, 9, 9, 9, 9, 9, 9, 9, 9, 9, 9],
              [9, 9, 41, 53, 9, 84, 9, 54, 43, 9, 27, 28, 28, 28, 28, 28, 28, 28, 28, 28, 29, 21, 21, 9, 9, 9, 9, 9, 9, 21, 21, 22],
              [9, 9, 47, 41, 42, 42, 42, 43, 49, 21, 30, 31, 31, 31, 31, 31, 31, 31, 35, 28, 29, 9, 21, 9, 21, 68, 69, 69, 69, 70, 21, 21],
              [41, 53, 9, 47, 48, 48, 48, 49, 9, 9, 9, 9, 84, 9, 54, 42, 43, 9, 27, 28, 29, 21, 22, 9, 9, 68, 69, 69, 69, 70, 9, 9],
              [44, 41, 53, 9, 9, 21, 9, 9, 9, 54, 42, 42, 42, 42, 43, 45, 46, 9, 27, 28, 29, 9, 21, 21, 9, 68, 74, 67, 74, 70, 9, 9],
              [44, 44, 41, 53, 21, 9, 9, 84, 54, 43, 45, 45, 45, 45, 46, 45, 46, 9, 27, 28, 33, 26, 9, 9, 9, 71, 72, 66, 72, 73, 9, 21],
              [47, 44, 44, 41, 42, 42, 42, 42, 43, 46, 45, 45, 45, 45, 46, 48, 49, 9, 27, 28, 28, 29, 21, 21, 9, 58, 27, 28, 29, 58, 21, 21],
              [9, 47, 44, 44, 45, 45, 45, 45, 46, 46, 48, 48, 48, 48, 49, 9, 21, 21, 27, 28, 28, 33, 25, 25, 25, 25, 36, 28, 33, 25, 25, 25],
              [9, 9, 47, 44, 45, 45, 45, 45, 46, 49, 21, 9, 21, 21, 21, 22, 24, 25, 36, 28, 28, 28, 28, 28, 28, 28, 28, 28, 28, 28, 28, 28],
              [9, 9, 9, 47, 48, 48, 48, 48, 49, 9, 24, 25, 25, 25, 25, 25, 36, 28, 28, 28, 28, 28, 34, 31, 31, 31, 31, 31, 31, 31, 31, 31],
              [13, 14, 9, 9, 21, 9, 9, 21, 21, 21, 27, 28, 28, 28, 28, 28, 28, 28, 34, 31, 31, 31, 32, 22, 9, 9, 9, 9, 9, 12, 13, 13],
              [85, 38, 13, 13, 13, 13, 14, 9, 9, 21, 30, 31, 31, 31, 31, 31, 31, 31, 32, 9, 9, 21, 21, 9, 84, 9, 9, 12, 13, 37, 85, 16],
              [16, 16, 16, 85, 16, 16, 38, 13, 13, 14, 21, 9, 84, 21, 21, 9, 84, 9, 12, 13, 13, 13, 13, 13, 13, 13, 13, 37, 85, 85, 85, 16],
              [16, 85, 16, 16, 16, 85, 16, 16, 85, 38, 13, 13, 13, 13, 13, 13, 13, 13, 37, 85, 16, 16, 16, 16, 16, 16, 16, 16, 16, 16, 16, 16],
              [16, 86, 85, 16, 16, 85, 16, 16, 16, 16, 16, 16, 16, 16, 16, 85, 16, 16, 16, 16, 85, 85, 16, 85, 16, 86, 16, 16, 85, 16, 85, 16],
              [16, 16, 85, 85, 85, 16, 85, 16, 16, 16, 16, 16, 16, 16, 16, 85, 16, 16, 16, 16, 16, 16, 16, 85, 16, 85, 85, 85, 16, 85, 85, 16],
              [16, 85, 85, 16, 16, 16, 85, 16, 16, 85, 85, 16, 16, 16, 85, 85, 16, 16, 16, 16, 16, 16, 16, 16, 16, 16, 16, 16, 85, 85, 16, 16],
              [16, 85, 16, 16, 16, 16, 16, 16, 16, 16, 85, 16, 16, 16, 16, 16, 16, 16, 16, 16, 16, 16, 16, 16, 16, 16, 16, 16, 16, 16, 16, 16]],
             [[0, 0, 0, 0, 29, 30, 31, 0, 0, 0, 0, 0, 0, 0, 0, 0, 0, 0, 0, 0, 0, 0, 0, 0, 0, 0, 12, 14, 8, 0, 0, 0],
              [0, 0, 0, 0, 0, 0, 0, 0, 0, 0, 0, 26, 27, 28, 0, 0, 0, 0, 0, 0, 0, 0, 0, 0, 0, 12, 10, 13, 6, 8, 0, 0],
              [0, 0, 0, 0, 0, 0, 0, 0, 0, 0, 0, 29, 30, 31, 0, 0, 0, 0, 0, 0, 0, 0, 0, 0, 25, 10, 9, 15, 5, 6, 24, 0],
              [0, 0, 0, 0, 0, 0, 26, 27, 28, 0, 0, 0, 0, 0, 0, 0, 0, 0, 0, 0, 0, 0, 0, 0, 25, 9, 0, 0, 0, 5, 24, 0],
              [0, 0, 0, 0, 0, 0, 29, 30, 31, 0, 0, 0, 0, 0, 0, 0, 0, 0, 0, 0, 0, 0, 0, 0, 0, 0, 0, 0, 0, 0, 0, 0],
              [0, 0, 0, 0, 0, 0, 0, 0, 0, 0, 0, 0, 0, 0, 0, 0, 0, 0, 0, 0, 0, 0, 0, 0, 0, 1, 0, 0, 0, 1, 0, 0],
              [0, 0, 0, 0, 0, 0, 0, 0, 0, 0, 0, 0, 0, 0, 0, 0, 0, 0, 0, 0, 0, 0, 0, 0, 0, 0, 0, 0, 0, 0, 0, 0],
              [0, 0, 0, 0, 0, 0, 0, 0, 0, 0, 0, 0, 0, 0, 0, 0, 0, 0, 0, 0, 0, 0, 0, 0, 0, 0, 0, 0, 0, 0, 0, 0],
              [0, 0, 0, 0, 0, 0, 0, 0, 0, 0, 0, 0, 0, 0, 0, 0, 0, 0, 0, 0, 0, 0, 0, 0, 0, 0, 0, 0, 0, 0, 0, 0],
              [0, 0, 0, 0, 0, 0, 0, 0, 0, 0, 0, 0, 0, 0, 0, 0, 0, 0, 0, 0, 0, 0, 0, 26, 27, 28, 0, 0, 0, 0, 0, 0],
              [0, 0, 0, 0, 0, 0, 0, 0, 0, 0, 0, 26, 27, 28, 0, 26, 27, 28, 0, 0, 0, 0, 0, 29, 30, 31, 0, 0, 0, 0, 0, 0],
              [0, 0, 0, 0, 0, 0, 0, 0, 0, 0, 0, 29, 30, 31, 0, 29, 30, 31, 0, 0, 0, 0, 0, 0, 0, 0, 0, 0, 0, 0, 0, 0],
              [0, 0, 0, 0, 0, 0, 0, 0, 0, 0, 0, 0, 0, 0, 0, 0, 0, 0, 0, 0, 0, 0, 0, 0, 0, 0, 0, 0, 0, 0, 0, 0],
              [0, 0, 0, 0, 0, 0, 0, 0, 0, 0, 0, 0, 0, 0, 0, 0, 0, 0, 0, 0, 0, 0, 0, 0, 0, 0, 0, 0, 0, 0, 0, 0],
              [0, 0, 0, 0, 0, 0, 0, 0, 0, 0, 0, 0, 0, 0, 0, 0, 0, 0, 0, 0, 0, 0, 0, 0, 0, 0, 0, 0, 0, 0, 0, 0],
              [0, 0, 0, 0, 0, 0, 0, 0, 0, 0, 0, 0, 0, 0, 0, 0, 0, 0, 0, 0, 0, 0, 0, 0, 0, 0, 0, 0, 0, 0, 0, 0],
              [0, 0, 0, 0, 0, 0, 0, 0, 0, 0, 0, 0, 0, 0, 0, 0, 0, 0, 0, 0, 0, 0, 0, 0, 0, 0, 0, 0, 0, 0, 0, 0],
              [0, 0, 0, 0, 0, 0, 0, 0, 0, 0, 0, 0, 0, 0, 0, 0, 0, 0, 0, 0, 0, 0, 0, 0, 0, 0, 0, 0, 0, 0, 0, 0]],
             {(31, 8): [get_demo2, (1, 8)], (27, 5): [get_demo_house, (8, 7)], (27, 4): [get_demo_house, (8, 7)], (31, 7): [get_demo2, (1, 7)], (31, 9): [get_demo2, (1, 9)]},
             lightmap=[(25, 5), (29, 5), (12, 9)],
             default_start=(0, 0), name="Demo")