tile_dict = {9: 'tiles/grass.png', 12: 'tiles/top_left_water.png', 15: 'tiles/left_water.png', 16: 'tiles/water.png', 18: 'tiles/bottom_left_water.png', 22: 'tiles/grass2.png', 25: 'tiles/top_path.png', 26: 'tiles/top_right_path.png', 28: 'tiles/path.png', 29: 'tiles/right_path.png', 31: 'tiles/bottom_path.png', 32: 'tiles/bottom_right_path.png', 37: 'tiles/water_corner1.png', 40: 'tiles/water_corner4.png', 58: 'tiles/lamp_post_bottom.png', 84: 'tiles/tree_trunk.png', 85: 'tiles/water2.png'}
    deco_dict = {1: 'tiles/lamp_post_top.png', 26: 'tiles/tree_top_left.png', 27: 'tiles/tree_top.png', 28: 'tiles/tree_top_right.png', 29: 'tiles/tree_mid_left.png', 30: 'tiles/tree_mid.png', 31: 'tiles/tree_mid_right.png'}
    t_ids = build_id_list(tile_dict)
    d_ids = build_id_list(deco_dict)

    colliders = [12, 15, 16, 18, 37, 40, 58, 84]

    tilemap = [[9, 9, 9, 9, 9, 9, 18, 40, 85, 85, 16, 16, 16, 16, 85, 16],
               [9, 22, 9, 9, 9, 9, 9, 18, 40, 85, 85, 85, 85, 85, 85, 85],
               [9, 84, 9, 9, 9, 9, 9, 9, 15, 85, 85, 85, 85, 85, 16, 85],
               [9, 9, 9, 22, 9, 9, 84, 9, 15, 85, 85, 85, 85, 85, 16, 16],
               [9, 9, 9, 9, 9, 9, 9, 9, 15, 85, 85, 85, 85, 16, 85, 16],
               [9, 22, 9, 9, 9, 9, 9, 12, 37, 85, 85, 16, 85, 85, 85, 16],
               [9, 9, 58, 9, 22, 9, 12, 37, 85, 16, 85, 85, 85, 85, 85, 16],
               [25, 25, 25, 25, 26, 9, 18, 40, 85, 85, 85, 85, 85, 85, 16, 16],
               [28, 28, 28, 28, 29, 9, 9, 15, 85, 85, 85, 16, 85, 85, 85, 16],
               [31, 31, 31, 31, 32, 9, 9, 15, 85, 16, 85, 16, 85, 16, 16, 16],
               [9, 9, 9, 9, 9, 9, 12, 37, 85, 85, 16, 16, 85, 85, 16, 16],
               [9, 22, 9, 9, 9, 9, 15, 85, 16, 85, 85, 85, 16, 85, 85, 16],
               [9, 9, 9, 9, 22, 9, 15, 85, 16, 16, 85, 85, 16, 85, 85, 85],
               [9, 9, 84, 9, 9, 9, 15, 85, 85, 16, 16, 85, 85, 85, 85, 85],
               [9, 9, 9, 9, 9, 12, 37, 85, 85, 85, 85, 85, 16, 85, 85, 16],
               [9, 9, 9, 9, 9, 15, 85, 16, 85, 16, 85, 85, 16, 85, 16, 16],
               [9, 9, 9, 9, 9, 15, 85, 16, 16, 85, 85, 85, 16, 16, 16, 85],
               [22, 9, 9, 84, 9, 15, 85, 16, 85, 85, 85, 85, 16, 16, 85, 85]]

    decomap = [[26, 27, 28, 0, 0, 0, 0, 0, 0, 0, 0, 0, 0, 0, 0, 0],
               [29, 30, 31, 0, 0, 26, 27, 28, 0, 0, 0, 0, 0, 0, 0, 0],
               [0, 0, 0, 0, 0, 29, 30, 31, 0, 0, 0, 0, 0, 0, 0, 0],
               [0, 0, 0, 0, 0, 0, 0, 0, 0, 0, 0, 0, 0, 0, 0, 0],
               [0, 0, 0, 0, 0, 0, 0, 0, 0, 0, 0, 0, 0, 0, 0, 0],
               [0, 0, 1, 0, 0, 0, 0, 0, 0, 0, 0, 0, 0, 0, 0, 0],
               [0, 0, 0, 0, 0, 0, 0, 0, 0, 0, 0, 0, 0, 0, 0, 0],
               [0, 0, 0, 0, 0, 0, 0, 0, 0, 0, 0, 0, 0, 0, 0, 0],
               [0, 0, 0, 0, 0, 0, 0, 0, 0, 0, 0, 0, 0, 0, 0, 0],
               [0, 0, 0, 0, 0, 0, 0, 0, 0, 0, 0, 0, 0, 0, 0, 0],
               [0, 0, 0, 0, 0, 0, 0, 0, 0, 0, 0, 0, 0, 0, 0, 0],
               [0, 26, 27, 28, 0, 0, 0, 0, 0, 0, 0, 0, 0, 0, 0, 0],
               [0, 29, 30, 31, 0, 0, 0, 0, 0, 0, 0, 0, 0, 0, 0, 0],
               [0, 0, 0, 0, 0, 0, 0, 0, 0, 0, 0, 0, 0, 0, 0, 0],
               [0, 0, 0, 0, 0, 0, 0, 0, 0, 0, 0, 0, 0, 0, 0, 0],
               [0, 0, 26, 27, 28, 0, 0, 0, 0, 0, 0, 0, 0, 0, 0, 0],
               [0, 0, 29, 30, 31, 0, 0, 0, 0, 0, 0, 0, 0, 0, 0, 0],
               [0, 0, 0, 0, 0, 0, 0, 0, 0, 0, 0, 0, 0, 0, 0, 0]]

    loading_zones = {(0, 8): [demo, (30, 8)], (0, 7): [demo, (30, 7)], (0, 9): [demo, (30, 9)]}

    return t_ids, tilemap, d_ids, decomap, colliders, loading_zones