[[9, 9, 9, 9, 22, 9, 9, 9, 9, 22, 12, 13, 13, 14, 22, 9, 9, 9, 9, 10, 23, 23, 23, 23, 23, 23, 23, 10],
 [9, 9, 10, 23, 23, 23, 23, 23, 10, 9, 15, 39, 40, 17, 24, 25, 25, 25, 25, 11, 8, 8, 8, 8, 8, 8, 8, 10],
 [22, 9, 10, 8, 8, 8, 8, 8, 10, 21, 15, 17, 15, 17, 27, 28, 28, 28, 28, 8, 8, 8, 8, 8, 8, 8, 8, 10],
 [9, 9, 10, 8, 8, 8, 8, 2, 10, 21, 15, 17, 15, 17, 27, 34, 31, 31, 31, 10, 8, 8, 8, 8, 8, 8, 8, 10],
 [9, 9, 10, 8, 8, 8, 8, 5, 10, 9, 15, 38, 37, 17, 27, 29, 10, 23, 23, 23, 8, 8, 8, 8, 8, 8, 8, 10],
 [9, 9, 11, 11, 11, 8, 11, 11, 11, 22, 18, 19, 19, 20, 27, 29, 10, 8, 8, 8, 8, 8, 8, 8, 8, 8, 8, 10],
 [9, 22, 9, 9, 27, 28, 29, 9, 22, 9, 21, 21, 21, 22, 27, 29, 10, 8, 8, 8, 8, 8, 8, 8, 8, 8, 8, 10],
 [25, 25, 25, 25, 36, 28, 33, 25, 25, 25, 25, 25, 25, 25, 36, 29, 10, 8, 8, 8, 8, 8, 8, 8, 8, 8, 8, 10],
 [28, 28, 28, 28, 28, 28, 28, 28, 28, 28, 28, 28, 28, 28, 28, 29, 11, 11, 11, 11, 8, 11, 11, 11, 11, 11, 11, 11],
 [31, 31, 35, 28, 34, 31, 31, 31, 31, 31, 31, 35, 28, 28, 28, 33, 25, 25, 25, 36, 28, 33, 25, 25, 25, 25, 25, 25],
 [9, 9, 27, 28, 29, 9, 9, 22, 9, 21, 22, 27, 28, 28, 28, 28, 28, 28, 28, 28, 28, 28, 34, 31, 35, 28, 34, 31],
 [22, 9, 27, 28, 29, 9, 9, 21, 21, 21, 21, 27, 28, 28, 28, 28, 28, 28, 28, 28, 28, 28, 29, 10, 23, 8, 23, 10],
 [10, 23, 23, 8, 23, 23, 23, 23, 23, 10, 21, 27, 28, 28, 34, 31, 31, 31, 31, 31, 31, 31, 32, 10, 8, 8, 8, 10],
 [10, 8, 8, 8, 8, 8, 8, 8, 8, 10, 21, 27, 28, 28, 29, 22, 10, 23, 23, 23, 23, 23, 23, 23, 8, 8, 8, 10],
 [10, 8, 8, 8, 8, 8, 8, 8, 8, 10, 22, 27, 28, 28, 29, 21, 10, 8, 8, 8, 8, 8, 8, 8, 8, 8, 8, 10],
 [10, 8, 8, 8, 8, 8, 8, 8, 8, 11, 25, 36, 28, 28, 33, 25, 11, 8, 8, 8, 8, 8, 8, 8, 8, 8, 8, 10],
 [10, 8, 8, 8, 8, 8, 8, 8, 8, 8, 28, 28, 28, 28, 28, 28, 8, 8, 8, 8, 8, 8, 8, 8, 8, 8, 8, 10],
 [10, 8, 8, 8, 8, 8, 8, 8, 8, 10, 31, 31, 31, 31, 31, 31, 10, 8, 8, 8, 8, 8, 3, 2, 2, 2, 2, 10],
 [10, 8, 8, 8, 8, 8, 8, 8, 8, 10, 9, 22, 9, 9, 22, 9, 10, 8, 8, 8, 8, 8, 3, 22, 22, 22, 22, 10],
 [10, 8, 8, 8, 8, 8, 8, 8, 8, 10, 9, 9, 9, 21, 22, 9, 11, 11, 11, 11, 11, 11, 11, 11, 11, 11, 11, 11],
 [11, 11, 11, 11, 11, 11, 11, 11, 11, 11, 9, 22, 22, 21, 21, 21, 21, 21, 21, 21, 21, 21, 21, 21, 9, 9, 9, 9]]

{2: 'tiles/stone_table_top.png', 3: 'tiles/stone_table_left.png', 5: 'tiles/stone_table_bottom.png', 8: 'tiles/wood.png', 9: 'tiles/grass.png', 10: 'tiles/corner.png', 11: 'tiles/wall.png', 12: 'tiles/top_left_water.png', 13: 'tiles/top_water.png', 14: 'tiles/top_right_water.png', 15: 'tiles/left_water.png', 17: 'tiles/right_water.png', 18: 'tiles/bottom_left_water.png', 19: 'tiles/bottom_water.png', 20: 'tiles/bottom_right_water.png', 21: 'tiles/grass3.png', 22: 'tiles/grass2.png', 23: 'tiles/pink_wall.png', 24: 'tiles/top_left_path.png', 25: 'tiles/top_path.png', 27: 'tiles/left_path.png', 28: 'tiles/path.png', 29: 'tiles/right_path.png', 31: 'tiles/bottom_path.png', 32: 'tiles/bottom_right_path.png', 33: 'tiles/path_corner1.png', 34: 'tiles/path_corner2.png', 35: 'tiles/path_corner3.png', 36: 'tiles/path_corner4.png', 37: 'tiles/water_corner1.png', 38: 'tiles/water_corner2.png', 39: 'tiles/water_corner3.png', 40: 'tiles/water_corner4.png'}