tilemap = [[9, 21, 9, 9, 9, 9, 9, 9, 9, 9, 21, 21, 9, 9, 21, 9],
               [9, 21, 9, 9, 10, 11, 11, 11, 11, 11, 11, 11, 10, 9, 22, 21],
               [9, 21, 22, 9, 10, 8, 8, 8, 8, 8, 8, 8, 10, 9, 9, 21],
               [21, 9, 9, 9, 10, 8, 8, 8, 8, 8, 8, 8, 10, 21, 21, 9],
               [21, 9, 21, 9, 10, 8, 8, 8, 8, 8, 8, 8, 10, 9, 9, 9],
               [9, 21, 9, 9, 10, 8, 8, 8, 8, 8, 8, 8, 10, 9, 9, 9],
               [9, 21, 21, 21, 11, 11, 11, 11, 8, 11, 11, 11, 11, 9, 21, 9],
               [9, 9, 22, 21, 9, 9, 9, 9, 9, 9, 9, 22, 9, 9, 9, 22],
               [9, 9, 9, 9, 21, 21, 9, 22, 21, 9, 21, 9, 9, 9, 9, 9]]

{8: 'tiles/wood.png', 9: 'tiles/grass.png', 10: 'tiles/corner.png', 11: 'tiles/wall.png', 21: 'tiles/grass3.png', 22: 'tiles/grass2.png'}

decomap = [[0, 0, 0, 0, 0, 0, 0, 0, 0, 0, 0, 0, 0, 0, 0, 0],
               [0, 0, 0, 0, 0, 0, 0, 0, 0, 0, 0, 0, 0, 0, 0, 0],
               [0, 0, 0, 0, 0, 0, 0, 0, 0, 0, 0, 0, 0, 0, 0, 0],
               [0, 0, 0, 0, 0, 0, 0, 0, 0, 0, 0, 0, 0, 0, 0, 0],
               [0, 0, 0, 0, 0, 0, 0, 0, 0, 0, 0, 0, 0, 0, 0, 0],
               [0, 0, 0, 0, 0, 0, 0, 0, 0, 0, 0, 0, 0, 0, 0, 0],
               [0, 0, 0, 0, 0, 0, 0, 0, 0, 0, 0, 0, 0, 0, 0, 0],
               [0, 0, 0, 0, 0, 0, 0, 0, 0, 0, 0, 0, 0, 0, 0, 0],
               [0, 0, 0, 0, 0, 0, 0, 0, 0, 0, 0, 0, 0, 0, 0, 0]]

{}

colliders = [10, 11]