[[9, 9, 21, 9, 9, 9, 9, 12, 13, 13, 14, 9, 9, 9, 9, 22, 21, 9, 9, 9, 9, 22, 9, 21, 9, 9, 21, 9, 9, 22, 9, 9],
 [21, 9, 9, 9, 22, 9, 12, 16, 16, 16, 38, 14, 9, 9, 9, 9, 9, 9, 9, 10, 23, 23, 23, 23, 23, 10, 23, 23, 23, 23, 10],
 [9, 21, 9, 9, 9, 12, 37, 16, 16, 16, 16, 38, 14, 9, 24, 25, 25, 25, 26, 10, 8, 8, 8, 8, 8, 10, 8, 8, 8, 8, 10],
 [9, 9, 9, 21, 9, 15, 16, 16, 16, 16, 16, 16, 17, 9, 30, 31, 35, 28, 29, 10, 8, 8, 8, 8, 8, 10, 8, 8, 8, 8, 10],
 [9, 9, 9, 21, 9, 18, 40, 16, 16, 16, 16, 16, 17, 21, 21, 21, 27, 28, 29, 10, 8, 8, 8, 8, 8, 10, 8, 8, 8, 8, 10],
 [9, 22, 9, 21, 21, 9, 15, 16, 16, 16, 16, 39, 20, 9, 9, 9, 27, 28, 29, 11, 11, 11, 10, 23, 8, 23, 23, 8, 23, 23, 10],
 [9, 9, 9, 9, 21, 9, 18, 40, 16, 16, 39, 20, 9, 9, 9, 9, 27, 28, 29, 9, 9, 9, 10, 8, 8, 8, 8, 8, 8, 8, 10],
 [21, 21, 21, 21, 21, 9, 9, 18, 19, 19, 20, 9, 9, 21, 21, 9, 27, 28, 29, 9, 22, 9, 10, 8, 8, 8, 8, 8, 8, 8, 10],
 [9, 9, 21, 21, 21, 9, 9, 9, 9, 9, 9, 9, 9, 9, 21, 9, 27, 28, 29, 21, 21, 9, 11, 11, 8, 8, 11, 11, 11, 11, 11],
 [9, 9, 9, 9, 21, 21, 21, 21, 21, 21, 21, 21, 9, 9, 21, 21, 27, 28, 29, 9, 21, 9, 9, 27, 28, 28, 29, 9, 9, 21, 9],
 [13, 14, 9, 9, 21, 9, 9, 9, 9, 9, 9, 21, 9, 22, 9, 9, 27, 28, 33, 25, 25, 25, 25, 36, 28, 28, 29, 9, 21, 21, 21],
 [16, 38, 14, 9, 9, 9, 21, 21, 22, 9, 9, 21, 21, 9, 9, 9, 27, 28, 28, 28, 28, 28, 28, 28, 28, 28, 29, 9, 21, 22, 9],
 [16, 16, 38, 14, 9, 9, 9, 9, 9, 9, 9, 9, 21, 9, 9, 9, 30, 31, 31, 31, 31, 31, 31, 31, 31, 31, 32, 9, 9, 12, 13],
 [16, 16, 16, 38, 13, 13, 13, 13, 13, 13, 14, 9, 9, 21, 9, 9, 9, 9, 9, 9, 9, 12, 13, 13, 13, 13, 13, 13, 13, 37, 16],
 [16, 16, 16, 16, 16, 16, 16, 16, 16, 16, 38, 13, 13, 13, 13, 13, 13, 13, 13, 13, 13, 37, 16, 16, 16, 16, 16, 16, 16, 16, 16],
 [16, 16, 16, 16, 16, 16, 16, 16, 16, 16, 16, 16, 16, 16, 16, 16, 16, 16, 16, 16, 16, 16, 16, 16, 16, 16, 16, 16, 16, 16, 16],
 [16, 16, 16, 16, 16, 16, 16, 16, 16, 16, 16, 16, 16, 16, 16, 16, 16, 16, 16, 16, 16, 16, 16, 16, 16, 16, 16, 16, 16, 16, 16],
 [16, 16, 16, 16, 16, 16, 16, 16, 16, 16, 16, 16, 16, 16, 16, 16, 16, 16, 16, 16, 16, 16, 16, 16, 16, 16, 16, 16, 16, 16, 16]]

{8: 'tiles/wood.png', 9: 'tiles/grass.png', 10: 'tiles/corner.png', 11: 'tiles/wall.png', 12: 'tiles/top_left_water.png', 13: 'tiles/top_water.png', 14: 'tiles/top_right_water.png', 15: 'tiles/left_water.png', 16: 'tiles/water.png', 17: 'tiles/right_water.png', 18: 'tiles/bottom_left_water.png', 19: 'tiles/bottom_water.png', 20: 'tiles/bottom_right_water.png', 21: 'tiles/grass3.png', 22: 'tiles/grass2.png', 23: 'tiles/pink_wall.png', 24: 'tiles/top_left_path.png', 25: 'tiles/top_path.png', 26: 'tiles/top_right_path.png', 27: 'tiles/left_path.png', 28: 'tiles/path.png', 29: 'tiles/right_path.png', 30: 'tiles/bottom_left_path.png', 31: 'tiles/bottom_path.png', 32: 'tiles/bottom_right_path.png', 33: 'tiles/path_corner1.png', 35: 'tiles/path_corner3.png', 36: 'tiles/path_corner4.png', 37: 'tiles/water_corner1.png', 38: 'tiles/water_corner2.png', 39: 'tiles/water_corner3.png', 40: 'tiles/water_corner4.png'}